1111111111111111111
1000100000000000001
1000100000000000001
1000000004000000001
1000001000001004001
1000001000001000001
1004001000001000001
1000001000001000001
1000001030001000031
1111111111111111111